1111111111111111111111
100C11100E0000011000C1
10111001111C1101100011
100000100C000001111011
1P11110C11110010001C01
1011100111110000001101
101110C1110C0001000001
100C001100001111110001
1111111111111111111111