111111111111 11
10C1CC111001 11
1100000011C1 11
1011001C1Z01 11
100010001111 11
1Z100C0010C1 11
11111111111