11111111
1C0C0CC1
100C00E1
1C1110P1
11111111